,Mes,T Accidente: Choques,T Accidente: Derrapes,Total de Accidentes,Precipitacion/Mes
0,Enero,186,138,324,7.6mm
1,Febrero,150,129,279,7mm
2,Marzo,219,146,365,8.9mm
3,Abril,181,145,326,22.5mm
4,Mayo,161,136,297,66.5mm
5,Junio,173,135,308,140mm
6,Julio,341,281,622,189.5mm
7,Agosto,312,296,608,171.2mm
8,Septiembre,323,324,647,139.8mm
9,Octubre,325,286,611,72.4mm
10,Noviembre,331,316,647,12.6mm
11,Diciembre,344,440,784,8.2mm
